0,0,0,0,0,0,0,0,0,0,0,0,0,0,0,0,0,0,0,0,0,0,0,0,0,0
0,0,0,3,0,0,0,0,0,0,0,0,0,0,3,0,0,0,0,1,0,0,0,0,0,0
0,0,0,0,0,0,0,0,0,0,0,0,0,0,0,0,0,0,0,1,0,0,0,0,0,0
0,0,0,0,0,0,0,0,0,0,0,0,0,0,0,0,0,0,0,1,0,0,0,0,0,0
0,0,1,1,1,1,1,0,0,1,1,1,1,1,1,1,1,0,0,6,6,6,1,1,0,0
0,0,0,0,0,0,1,0,0,0,0,0,0,0,0,0,0,0,0,1,0,0,0,0,0,0
0,0,0,0,0,0,1,0,0,0,0,0,0,0,0,0,0,0,0,1,0,0,0,0,0,0
8,8,8,1,1,1,1,1,1,1,1,1,1,1,1,1,1,1,1,1,1,1,1,8,8,8
8,8,8,0,0,0,0,0,0,0,0,0,0,0,0,0,0,0,0,0,0,0,0,8,8,8
8,8,8,0,0,0,0,0,0,0,0,0,0,0,0,0,0,0,0,0,0,0,0,8,8,8
8,8,8,1,1,1,1,1,6,6,0,0,1,1,1,1,1,1,1,1,1,1,1,8,8,8
8,8,8,0,0,1,1,1,6,6,0,0,0,0,0,0,0,0,0,1,1,0,0,8,8,8
8,8,8,0,0,1,1,1,0,0,0,0,0,0,0,0,0,0,0,1,1,0,0,8,8,8
8,8,8,0,0,1,1,1,0,0,0,0,0,0,0,0,0,6,6,1,1,0,0,8,8,8
8,8,8,1,1,1,1,1,1,1,1,1,1,1,1,0,0,1,1,1,1,1,1,8,8,8
0,0,0,0,0,0,0,0,0,0,0,0,0,0,0,0,0,0,0,0,0,0,0,0,0,0
0,0,0,0,0,0,0,0,0,0,0,0,0,0,0,0,0,0,0,0,0,0,0,0,0,0
0,0,0,0,0,1,0,0,1,0,0,0,0,0,0,0,0,0,1,0,0,1,0,0,1,1
1,1,1,0,0,1,0,0,1,0,0,0,0,0,0,0,0,0,1,0,0,1,0,0,1,0
1,1,1,0,0,1,0,0,1,0,0,0,0,0,0,0,0,0,1,0,0,1,0,0,1,0
1,1,1,0,0,1,0,0,1,0,0,0,4,0,0,0,0,0,1,0,0,1,0,0,0,0
0,0,0,0,0,1,0,0,1,0,0,0,0,0,0,0,0,0,1,0,0,1,0,0,0,0
0,0,0,0,0,1,0,0,1,0,0,0,0,0,0,0,0,0,1,0,0,1,0,0,0,0
1,1,1,1,0,1,0,0,1,0,0,1,1,1,1,0,0,0,1,0,0,1,0,1,1,1
0,0,1,0,0,1,0,0,1,0,0,1,5,0,1,0,0,0,1,0,0,1,0,0,0,1
0,0,1,0,0,1,0,0,1,0,0,1,0,0,1,0,0,0,1,0,0,1,0,0,0,1
