0,0,0,0,0,0,0,0,1,1,0,0,0,0,0,0,1,1,0,0,0,0,0,0,0,0
0,0,0,0,0,0,0,0,1,1,0,0,0,0,0,0,1,1,0,0,0,0,0,0,0,0
0,0,1,1,1,1,0,0,1,6,0,0,0,0,0,0,6,1,0,0,1,1,1,1,0,0
0,0,1,1,1,1,0,0,1,6,0,0,0,0,0,0,6,1,0,0,1,1,1,1,0,0
0,0,0,0,0,0,3,0,1,1,0,0,0,0,0,0,1,1,3,0,0,0,0,0,0,0
0,0,0,0,0,0,0,0,1,1,0,0,0,0,0,0,1,1,0,0,0,0,0,0,0,0
1,1,1,1,1,1,0,0,0,0,1,1,0,0,1,1,0,0,0,0,1,1,1,1,1,1
1,1,1,1,1,1,0,0,0,0,1,1,0,0,1,1,0,0,0,0,1,1,1,1,1,1
0,0,1,1,0,0,0,0,1,1,0,0,0,0,0,0,1,1,0,0,0,0,1,1,0,0
0,0,1,1,0,0,0,0,1,1,0,0,0,0,0,0,1,1,0,0,0,0,1,1,0,0
0,0,1,1,0,0,1,1,0,0,0,0,0,0,0,0,0,0,1,1,0,0,1,1,0,0
0,0,1,1,0,0,1,1,0,0,0,0,0,0,0,0,0,0,1,1,0,0,1,1,0,0
0,0,0,0,0,0,0,0,0,0,1,1,1,1,1,1,0,0,0,0,0,0,0,0,0,0
0,0,0,0,0,0,0,0,0,0,1,1,6,6,1,1,0,0,0,0,0,0,0,0,0,0
1,1,1,1,8,8,1,1,0,0,0,0,0,0,0,0,0,0,1,1,0,0,1,1,1,1
6,6,1,1,8,8,1,1,0,0,0,0,0,0,0,0,0,0,1,1,0,0,1,1,6,6
0,0,0,0,8,8,0,0,1,1,2,2,2,2,2,2,1,1,0,0,0,0,0,0,0,0
0,0,0,0,8,8,0,0,1,1,2,2,2,2,2,2,1,1,0,0,0,0,0,0,0,0
0,0,0,0,1,1,1,1,0,0,1,1,0,0,1,1,0,0,1,1,1,1,0,0,0,0
0,0,0,0,1,1,1,1,0,0,1,1,0,0,1,1,0,0,1,1,1,1,0,0,0,0
0,0,1,1,1,1,0,0,0,0,0,0,4,0,0,0,0,0,0,0,1,1,1,1,0,0
0,0,1,1,1,1,0,0,0,0,0,0,0,0,0,0,0,0,0,0,1,1,1,1,0,0
0,0,0,0,1,1,0,0,0,0,1,1,1,1,1,1,0,0,0,0,1,1,0,0,0,0
0,0,0,0,1,1,0,0,0,0,1,1,1,1,1,1,0,0,0,0,1,1,0,0,0,0
0,0,0,0,0,0,0,0,0,0,1,1,5,0,1,1,0,0,0,0,0,0,0,0,0,0
0,0,0,0,0,0,0,0,0,0,1,1,0,0,1,1,0,0,0,0,0,0,0,0,0,0
